############################
#            ##            #
#  # #  # #  ##  #  #  # # #
#  # #  # #  ##  #  #  # # #
#  # #  # #  ##  #  #  # # #
#                          #
# #### ## ######## ##  # # #
# #### ## ######## ##  # # #
#      ##    ##    ##      #
###### ####  ##  ####   # ##
#      ##### ## ##### #    #
#    # ##          ##      #
#    # ## ###  ### ## #    #
###### ## #      # ## ##  ##
          #      #         #
###  # ## #      # ## ##  ##
#    # ## ### #### ## #    #
#    # ##          ##      #
#    # ## ######## ## #    #
###### ## ######## ## ######
#            ##            #
#  ### ## ## ## ##### #### #
#  ### ## ## ## ##### #### #
#   ##                ##   #
##  ## ## ######## ## ## ###
##  ## ## ######## ## ## ###
#      ##    ##    ##      #
#  ######### ## #########  #
#  ######### ## #########  #
#                          #
############################